F 76,76,76
C 19,99,99

NO assets/textures/diamonds.xpm
SO assets/textures/skeleton.xpm
WE assets/textures/gold.xpm
EA assets/textures/lava.xpm

1111111111111111111
10W1001001001000001
1011000001000001001
1001001001111101111
1D01111000001001001
1000000000000001001
1001111111111001001
1111000000000001011
1000000001000000001
1111111111111111111
d
