NO assets/textures/red_brick.xpm
SO assets/textures/red_brick.xpm
WE assets/textures/red_brick.xpm
EA assets/textures/red_brick.xpm

F 20,20,20
C 200,200,200

111111111111111111111
1E0000000000000000001
111111111111111111111








1