NO assets/textures/red_brick.xpm
SO assets/textures/red_brick.xpm
WE assets/textures/red_brick.xpm
EA assets/textures/red_brick.xpm

F 18,53,25
C 153,204,255

111111111111
1         11
1       1111
1111111 1011
10S000111001
111111111111
11         1
111111111111
