NO assets/textures/diamonds.xpm
SO assets/textures/skeleton.xpm
WE assets/textures/gold.xpm
EA assets/textures/lava.xpm

F 18,53,25
C 153,204,255

111111111111
1         11
1          1
100000000001
10S000000001
110000000001
10         1
111111111111
